+++++++++++++++++++++++++
+  c   B       h        +
+   a    A  +           +
+  C     b  +      H    +
+          0+       g   +
+ +++++++++++++++++++++ +
+         f +           +
+   D       +           +
+    F   e  +   G       +
+           +           +
+     E    d+           +
+++++++++++++++++++++++++
