red:0,G,E,C
green:1,F,D,B
blue:2,I,H,A
+++++++++++++++
+adg      0GEC+
++++  +++  ++++
   +  +++  +   
   +  +++  +
++++  +++  ++++
+beh      1FDB+
++++  +++  ++++
   +  +++  +
   +  +++  +
++++  +++  ++++
+cfi      2IHA+
+++++++++++++++
