blue: 0,A
red: 1,B
green: 2,C
cyan: 3,D
magenta: 4,5,E
orange: 6,7,F
pink: 8,9,G
+++++++++++++++++++++++++++++++++++++++++++++++++++++++++++++++++++++
+                                                                   +
+         AA         A        A          A         AA               +
+  B      B               BB                 B                 B    +
+       CCC                      C                 C                +
+D             D               D                                  D +
+                                   EEE                             +
+                                           F                 F     +
+                                                        G          +
+                                                                   +
+                                                                   +
+                                                                   +
+                                                                   +
+                                                                   +
+                                                                   +
+                                                                   +
+                                                                   +
+                                                                   +
+                                                                   +
+                                                                   +
+                                                                   +
+                                                                   +
+                                                                   +
+                                                                   +
+                                                                   +
++++++++ +++++++++ +++++++++ +++++++++ +++++++++ ++++++++++ +++++++++
+      + +       + +       + +       + +       + +        + +       +
+      + +       + +       + +       + +       + +        + +       +
+      +++       +++       +++       + +       +++        +++       +
+      + +       + +       + +       + +       + +        + +       +
+      + +       + +       + +       + +       + +        + +       +
+      + +       + +       + +       + +       + +        + +       +
++++++++ +++++++++ +++++++++ +++++++++ +++++++++ ++++++++++ +++++++++
+                                                                   +
+                                                                   +
+                                                                   +
+                                                                   +
+                                                                   +
+                                                                   +
+                                                                   +
+                                                                   +
+                                                                   +
+                                                                   +
+                                                                   +
+                                                                   +
+                                                                   +
+                                                                   +
+                                                                   +
+                                                                   +
+                                                                   +
+                                              a                    +
+                                              a  b                 +
+                                              a  b  c              +
+                                              a  b  c  d           +
+                                              a  b  c  d  e        +
+                                              a  b  c  d  e  f     +
+0123456789                                    a  b  c  d  e  f  g  +
+++++++++++++++++++++++++++++++++++++++++++++++++++++++++++++++++++++