+++++++++++++++++++++++++++++++++++++++++
+                              C D      +
+                              G H      +
+                              I J      +
+                              E F      +
+                              A0B      +
+                                       +
+                                       +
+                                       +
+                                       +
+                                       +
+                                       +
+                                       +
+                                       +
+                                       +
+++a+++++++++++++++++++++++++++++++++++++
  +b+
  +c+
  +d+
  +e+
  +f+
  +g+
  +h+
  +i+
  +j+
  +++
