++++++++++++++++++
+0    + BC       +
+ + + + ++++ + + +
+ c c +    + b a +
+ + + ++++ + + + +
+          +     +
+++ ++++++++++ +++
+++     AC     +++
++++++++++++++++++
                