blue: 0,A,B,C,D
red: 1,F
++++++++++++++
+a          b+
+  +++B++++  +
+ +f       + +
+ A1       C +
+ +       F+ +
+0++++D++++  +
+d          c+
++++++++++++++