red: 0,A,B,C
 +++                +++
++ ++++++++++++++++++ ++
+ cA0                  +
++b++++++++++++++++++a++
+ B C                  +
++ ++++++++++++++++++ ++
 +++                +++